Afganistan = Kabul
Albania = Tirana
Algieria = Algier
Angola = Luanda
Arabia Saudyjska = Rijad
Argentyna = Buenos Aires
Australia = Canberra
Austria = Wieden
Belgia = Bruksela
Bialorus = Minsk
Boliwia = Sucre
Bosnia i Hercegowina = Sarajewo
Brazylia = Brasilla
Bulgaria = Sofia
Chile = Santiago
Chiny = Pekin
Chorwacja = Zagrzeb
Czad = Ndzamena
Czarnogora = Podgorica
Dania = Kopenhaga
Egipt = Kair
Ekwador = Quito
Estonia = Tallinn
Etiopia = Addis Abeba
Filipiny = Manila
Finlandia = Helsinki
Francja = Paryz
Ghana = Akra
Grecja = Ateny
Gruzja = Tbilisi
Hiszpania = Madryt
Holandia = Amsterdam
Honduras = Tequcigalpa
Indie = Nowe Delhi
Indonezja = Dzakarta
Irak = Bagdad
Iran = Teheran
Irlandia = Dublin
Islandia = Reykjavik
Izrael = Jerozolima
Japonia = Tokio
Kanada = Ottawa
Kazachstan = Astana
Kolumbia = Bogota
Korea Polnocna = Pjongjang 
Kosowo = Prisztina
Kuba = Hawana
Libia = Trypolis
Liechtenstein = Vaduz
Litwa = Wilno
Luksemburg = Luksemburg
Lotwa = Ryga
Macedonia Polnocna = Skopje
Madagaskar = Antananarywa
Maroko = Rabat
Meksyk = Meksyk
Moldawia = Kiszynow
Mongolia = Ulan bator
Nepal = Katmandu
Niemcy = Berlin
Niger = Niamey
Nigeria = Abudza
Norwegia = Oslo
Pakistan = Islamabad
Paragwaj = Asuncion
Peru = Lima
Portugalia = Lizbona
Czechy = Praga
Korea Poludniowa = Seul
RPA = Kapsztad
Rumunia = Bukareszt
Serbia = Belgrad
Slowacja = Bratyslawa
Slowenia = Lublana
Somalia = Mogadiszu
USA = Waszyngton
Sudan = Chartum
Sudan Poludniowy = Dzuba
Syria = Damaszek
Szwajcaria = Berno
Szwecja = Sztokholm
Tadzykistan = Duszanbe
Tailandia = Bangkok
Tanzania = Dodoma
Tunezja = Tunis
Turcja = Ankara
Turkmenistan = Aszchabad
Uganda = Kampala
Ukraina = Kijow
Urugwaj = Montevideo
Uzbekistan = Taszkent
Wenezuela = Caracas
Wegry = Budapeszt
Wielka Brytania = Londyn
Wietnam = Hanoi
Wlochy = Rzym
Zjednoczone Emiraty Arabskie = Abu Zabi
